0000000000000000000000000000
0000000000000000000000000000
0000000000000000000000000000
00000000000000000000        
                    000000  
00000                       
0000000                     
000000000000000000000000    
00                          
00                          
000000000000000000000000000 
        0000000000000000000 
    ----00000000            